1111111111111
10010M0000001
1M00011111001
1PCE110000M01
1111111111111
