1111111111111111111111111111111111
1E0000000000001C10001C100000000001
1010010100100001101001000000010101
1010010011101010001001000000010111
1P0000001C11C1000000000000000001C1
1111111111111111111111111111111111
